{
    "name": "level1",
    "width": "10",
    "height": "10",
    "data": [
       "X", "X", "X", "X", "X", "X", "X", "X", "X", "X",
       "X", ".", ".", ".", ".", "X", ".", ".", ".", "X",
       "X", ".", "X", "X", ".", "X", ".", "X", ".", "X",
       "X", ".", "X", "X", ".", ".", ".", "X", ".", "X",
       "X", ".", "X", "X", "X", "X", "X", "X", ".", "X",
       "X", ".", "X", "X", "X", "X", "X", "X", ".", "X",
       "X", ".", "X", "X", "X", ".", ".", "o", ".", "X",
       "X", ".", ".", ".", "X", ".", "X", "X", "c", "X",
       "X", "X", "X", ".", ".", ".", ".", ".", ".", "X",
       "X", "X", "X", "X", "X", "X", "X", "X", "X", "X"
    ],
    "mobs": [
        {
            "type": "human",
            "position": {
                "x": "1",
                "y": "1"
            }
        },
        {
            "type": "cpu",
            "position": {
                "x": "8",
                "y": "8"
            }
        }
    ]
}
