{
    "name": "level4",
    "width": "15",
    "height": "15",
    "data": [
        "X", "X", "X", "X", "X", "X", "X", "X", "X", "X", "X", "X", "X", "X", "X",
        "X", ".", ".", ".", "o", ".", ".", ".", ".", ".", ".", "X", "X", "X", "X",
        "X", ".", "X", "c", "X", "X", "X", ".", "X", "X", ".", "X", "X", "X", "X",
        "X", ".", "X", ".", ".", ".", "X", ".", "X", "X", ".", "X", "X", "X", "X",
        "X", ".", "X", "X", "X", ".", ".", ".", "X", "X", ".", "c", ".", ".", "X",
        "X", ".", "X", "X", "X", "X", "X", "X", "X", "X", "o", "X", "X", ".", "X",
        "X", ".", ".", ".", ".", ".", "X", "X", ".", ".", ".", "X", "X", ".", "X",
        "X", ".", "X", "X", "X", ".", "X", ".", ".", "X", ".", ".", ".", ".", "X",
        "X", ".", "X", "X", "X", ".", "X", ".", "X", "X", "X", "X", "X", ".", "X",
        "X", ".", "X", "X", "X", ".", "X", ".", ".", "X", "X", "X", "X", ".", "X",
        "X", ".", ".", ".", "X", ".", "X", "X", ".", "X", ".", ".", "c", ".", "X",
        "X", "X", "X", ".", "X", ".", "X", "X", ".", ".", ".", "X", "X", "o", "X",
        "X", "X", "X", ".", "X", "o", "X", "X", "X", "X", "X", "X", "X", ".", "X",
        "X", "X", "X", ".", "c", ".", ".", ".", ".", ".", ".", ".", ".", ".", "X",
        "X", "X", "X", "X", "X", "X", "X", "X", "X", "X", "X", "X", "X", "X", "X"
    ],
    "mobs": [
        {
            "position": {
                "x": "1",
                "y": "1"
            },
            "direction": {
                "x": "1",
                "y": "0"
            }
        },
        {
            "position": {
                "x": "13",
                "y": "13"
            },
            "direction": {
                "x": "-1",
                "y": "0"
            }
        },
        {
            "position": {
                "x": "3",
                "y": "10"
            },
            "direction": {
                "x": "-1",
                "y": "0"
            }
        },
        {
            "position": {
                "x": "10",
                "y": "5"
            },
            "direction": {
                "x": "0",
                "y": "1"
            }
        }
    ]
}
