{
    "name": "level3",
    "width": "10",
    "height": "10",
    "data": [
       "X", "X", "X", "X", "X", "X", "X", "X", "X", "X",
       "X", ".", ".", ".", ".", "o", ".", ".", ".", "X",
       "X", ".", "X", "X", "c", "X", "X", "X", ".", "X",
       "X", ".", "X", "X", ".", ".", ".", ".", ".", "X",
       "X", ".", "X", "X", "X", "X", "X", "X", ".", "X",
       "X", ".", "X", ".", ".", ".", "X", "X", ".", "X",
       "X", ".", "X", ".", "X", ".", ".", "o", ".", "X",
       "X", ".", "X", ".", "X", "X", "X", "X", "c", "X",
       "X", ".", ".", ".", ".", ".", ".", ".", ".", "X",
       "X", "X", "X", "X", "X", "X", "X", "X", "X", "X"
    ],
    "mobs": [
        {
            "position": {
                "x": "1",
                "y": "1"
            },
            "direction": {
                "x": "1",
                "y": "0"
            }
        },
        {
            "position": {
                "x": "8",
                "y": "8"
            },
            "direction": {
                "x": "-1",
                "y": "0"
            }
        }
    ]
}

