{
    "name": "level4",
    "width": "15",
    "height": "15",
    "data": [
        "X", "X", "X", "X", "X", "X", "X", "X", "X", "X", "X", "X", "X", "X", "X",
        "X", ".", "X", "X", "X", "X", "X", "X", "X", "X", "X", "X", "X", "X", "X",
        "X", ".", "X", "X", "X", "X", "X", "X", "X", "X", "X", "X", "X", "X", "X",
        "X", ".", "X", "X", "X", "X", "X", "X", "X", "X", "X", "X", "X", "X", "X",
        "X", ".", "X", "X", "X", "X", "X", "X", "X", "X", "X", "X", "X", "X", "X",
        "X", ".", "X", "X", "X", "X", "X", "X", "X", "X", "X", "X", "X", "X", "X",
        "X", ".", "X", "X", "X", "X", "X", "X", "X", "X", "X", "X", "X", "X", "X",
        "X", ".", "X", "X", "X", "X", "X", "X", "X", "X", "X", "X", "X", "X", "X",
        "X", ".", "X", "X", "X", "X", "X", "X", "X", "X", "X", "X", "X", "X", "X",
        "X", ".", "X", "X", "X", "X", "X", "X", "X", "X", "X", "X", "X", "X", "X",
        "X", ".", ".", ".", "X", "X", "X", "X", "X", "X", "X", "X", "X", "X", "X",
        "X", "X", "X", ".", "X", "X", "X", "X", "X", "X", "X", "X", "X", "X", "X",
        "X", "X", "X", ".", "X", "X", "X", "X", "X", "X", "X", "X", "X", "X", "X",
        "X", "X", "X", ".", ".", ".", "X", "X", "X", "X", "X", "X", "X", "X", "X",
        "X", "X", "X", "X", "X", "X", "X", "X", "X", "X", "X", "X", "X", "X", "X"
    ],
    "mobs": []
}
